PhysicalSwitch	KEYWORD1
SwitchState	KEYWORD1
Bridge	KEYWORD1
Controller	KEYWORD1
ActivateState	KEYWORD2
TurnOff	KEYWORD2
Activate	KEYWORD2
Deactivate	KEYWORD2
GetNext	KEYWORD2
GetPrevious	KEYWORD2
SetNext	KEYWORD2
SetPrevious	KEYWORD2
InsertSwitchState	KEYWORD2
GetNumberOfSwitches	KEYWORD2
GetSwitches	KEYWORD2
Logic	KEYWORD2
CalculateOffset	KEYWORD2
CalculateTransitions	KEYWORD2
ActivateNextState	KEYWORD2
ActivatePreviousState	KEYWORD2
